#########################################
#        .   #             .            #
#            #          #########       #
#.           #                         .#
#######  #########  ####        #########
#                                       #
#                                       #
#                       ###########     #
#    ######             # .. #.   #     #
#        .#             #    #          #
#         #             #    ######     #
#      .  #                             #
#########################################